0500:bee006b40eac80f8007407cd10ea05005000ea00000008000000000000000000
0520:0000000000000000000000000000000000000000000000000000000000000000
0540:0000000000000000000000000000000000000000000000000000000000000000
0560:0000000000000000000000000000000000000000000000000000000000000000
0580:0000000000000000000000000000000000000000000000000000000000000000
05a0:0000000000000000000000000000000000000000000000000000000000000000
05c0:0000000000000000000000000000000000000000000000000000000000000000
05e0:0000000000000000000000000000000000000000000000000000000000000000
0600:0000000000000000000000000000000000000000000000000000000000000000
0620:0000000000000000000000000000000000000000000000000000000000000000
0640:0000000000000000000000000000000000000000000000000000000000000000
0660:0000000000000000000000000000000000000000000000000000000000000000
0680:0000000000000000000000000000000000000000000000000000000000000000
06a0:0000000000000000000000000000000000000000000000000000000000000000
06c0:0000000000000000000000000000000000000000000000000000000000000000
06e0:48656c6c6f2c20776f726c64210a0d0000000000000000000000000000000000

mov si, 0x06e0    ; bee006
mov ah, 0x0e      ; b40e
lodsb             ; ac
cmp al, 0         ; 80f800
je end            ; 7407
int 0x10          ; cd10
jmp 0x50:0005     ; ea050050
jmp 0x800:0000    ; ea00000008
